Generating...
███████████████████████S███████████████████████████████████████████████████████████████████████████
█             █     █     █                   █   █     █       █       █ █   █   █     █     █   █
█ ███████ █ ███ █ ███ █ █ █ ███████████████ █ █ █ █ ███ █ ███████ ███ █ █ █ █ █ █ █ █ █ █ █████ █ █
█   █   █ █   █ █ █   █ █ █     █       █   █   █   █     █         █ █ █   █ █ █   █ █ █       █ █
█████ █ █████ █ █ █ ███ █ █████ ███ █ ███ █████████████████ █████████ █ █████ █ █████ █ █████████ █
█     █       █ █   █   █ █   █ █   █ █   █   █   █   █     █ █   █   █   █   █     █ █ █       █ █
█ █████ ███████ █████ ███ █ █ █ █ █████ █ █ █ █ █ █ █ █ █████ █ █ █ █████ █ ███████ █ ███ ███ ███ █
█ █   █ █   █   █   █   █ █ █   █     █ █ █ █   █ █ █ █ █     █ █ █ █       █   █   █     █ █     █
█ █ █ █ █ █ █ ███ █ ███ █ █ ███████ █ █ ███ █████ █ █ █ ███ ███ █ █ ███ █████ █ █ █████████ ███████
█ █ █   █ █   █   █ █ █ █ █       █ █ █   █   █ █   █   █   █   █ █   █ █     █ █       █   █     █
█ █ █████ █████ ███ █ █ █████████ ███ ███ ███ █ █████████ ███ ███ ███ ███ █████ ███████ █ ███ ███ █
█ █     █ █     █     █             █   █   █ █         █     █     █ █   █   █     █   █ █   █   █
█ █████ █ █ █████ █████████████████ ███ ███ █ █ ███████ ███████ ███ █ █ ███ █ █████ █ ███ █ ███ ███
█ █   █ █ █   █   █         █   █       █ █ █   █     █ █   █   █   █ █     █ █   █ █   █     █   █
█ █ █ ███ █ █ █████ █████ █ █ █ █ █████ █ █ █████ ███ █ █ █ █ ███ ███ ███████ █ █ █ ███ █████████ █
█ █ █     █ █ █   █ █     █ █ █ █ █   █   █     █ █ █   █ █ █   █ █         █ █ █ █   █         █ █
█ █ █████████ █ █ █ █ █████ █ █ ███ █ █████████ █ █ █████ █ ███ █ █ ███████ █ ███ █ ███████████ █ █
█ █ █   █   █   █   █ █ █   █ █     █           █ █       █     █ █ █ █   █ █ █   █             █ █
█ █ █ █ █ █ █ ███████ █ █ ███ █████████████ █████ █ ███████████████ █ █ █ █ █ █ █████████████████ █
█   █ █   █ █   █     █ █ █ █   █     █     █     █     █         █ █ █ █   █ █     █     █       █
█ ███ █████ ███ █ █████ █ █ ███ █ ███ ███ ███ █████ ███ █ ███████ █ █ █ █████ ███ █ █ ███ █ ███ █ █
█   █   █ █ █   █ █     █   █ █     █   █   █     █   █ █       █ █ █     █ █   █ █   █   █ █   █ █
███ ███ █ █ █████ █████ ███ █ █████████ █████████ ███ █ █ ███████ █ █████ █ ███ █████ █ ███ █ ███ █
█ █     █   █   █     █     █   █       █       █ █   █   █   █   █   █   █ █   █   █ █     █   █ █
█ ███████ ███ █ █████ █████ ███ █ ███████ ███ ███ █████████ █ █ █████ ███ █ █ ███ █ ███████ ███ ███
█ █       █   █     █     █     █ █       █ █   █       █   █   █   █   █   █     █       █   █   █
█ █ ███████ ███████ ███ █ ███ ███ █ ███████ ███ ███████ █ ███ ███ █ ███ ███ █████████████ ███ ███ █
█   █       █     █   █ █ █   █   █ █         █       █ █ █ █ █   █     █   █           █   █   █ █
█ ███████ █ ███ █████ ███ █ ███ ███ █ ███████ ███ █████ █ █ █ █ ███ █████ █████████ ███ ███ █████ █
█       █ █   █ █   █   █ █   █   █   █   █   █ █     █ █ █   █ █   █   █         █   █   █     █ █
███████ █████ █ █ █ ███ █ ███ ███ ███████ █ ███ █████ █ █ █ ███ █████ █ █████████ █████ ███████ █ █
█       █     █ █ █   █ █   █ █   █       █       █ █   █ █   █       █ █       █       █     █ █ █
█ ███████ █████ █ █ █ █ ███ ███ █ █ ███ █████████ █ █████ █████████████ █ █████ ███████ █ ███ █ █ █
█ █       █       █ █ █   █   █ █   █   █   █     █   █             █ █   █   █ █     █ █   █ █   █
█ █ █████ █ ███████ █████ █ █ █ █████████ █ █ █████ █ █████████ ███ █ █████ ███ █ ███ █ ███ █ ███ █
█ █ █   █ █ █     █   █   █ █ █ █   █     █   █     █         █ █ █       █ █   █ █ █ █   █ █   █ █
█ ███ █ █ █ ███ █ ███ █ █████ █ █ █ █ ███████████ ███████████ █ █ ███████ █ █ ███ █ █ █████ █ ███ █
█     █   █     █   █         █   █               █             █           █       █       █     █
███████████████████████████████████████████████████████████████████████████████████████████E███████
